1,3,4,5,7,8
2,4,3,0,0,0
3,6,5,0,0,0
4,8,6,0,0,0
5,3,12,0,0,0
6,2,13,0,0,0
7,8,0,0,0,0
8,3,0,0,0,0